#############################################################################################################################################
#.............#...#...........#...#...................#.........#...........#...................................#.............#.......#>>>>E#
#.#####.#####.#.#.#.###.#####.#.#.#.#.#########.#####.#.#######.#.#########.#######.###.###.###.#.#######.#.###.#.#########.#.#####.#.#>#.#.#
#.#...#...#.#...#.#...#.....#.#.#.#.#.....#.....#...#...#.......#...#.....#.....#...#.#.....#.#.#.#.....#.#...#.#.#.#.......#...#...#.#>#.#.#
###.#.#.#.#.###.#.###.#.###.#.#.#.#.#.###.#.#####.#######.#########.###.#######.#.###.#######.#.#.#####.#.###.#.#.#.#.#########.#.###.#>#.#.#
#...#.#.#.#...#.....#...#...#...#...#.#.#...#...#.......#.........#...#.........#.#.#.........#.#.......#.#...#.#.#.#.....#.....#.#...#>#.#.#
#.###.###.#.###.#########.#####.#####.#.#####.#.#.#.#############.#.#.#####.#####.#.#.###.###.#.###.#####.#.###.#.#.#####.###.###.#.###>#.###
#.#.......#.....#.....#...#.....#.....#.......#...#.............#.#.#.....#.#.....#.#...#...#.#.#...#.....#.#.#.#.....#.#...#...#.#.#..>#...#
#.#########.###.#.#.###.###.###.#.#####.#################.#######.#.#####.#.#.#####.###.###.#.#.###.#.#####.#.#.#####.#.###.###.#.###.#>#.#.#
#.#...#.....#.#...#...#.#.#.#.#.#.........#.............#...#.....#.....#.#.#...#...#...#...#.#...#.#.#...#...#...........#.#..........>..#.#
#.#.#.#####.#.#.#####.#.#.#.#.#.#######.#.#.#######.###.###.#.#######.###.#.###.#.#.#.#.#.###.###.###.#.#.###.###########.#.#.#####.###>#.#.#
#...#.....#...#...#...#.#.#...#.........#...#.....#...#.#...#...#.#...#...#.....................#...#...#...#.......#...#.#.#.#.......#>#...#
#.#######.#####.###.#.#.#.#.#####.#####.#####.###.#####.#.#####.#.#.###.#########.#.#.#.###.#######.#.#.#.#####.#####.#.#.#.###.#.#####>#.###
#.#.....#.....#.#...#.#.#...#.....#...#.#.#...#.....#...#.....#.#...#...#.........#.#.....#.#.......#...#.......#.....#.#.#...#...#>>>>>#...#
#.#.###.###.#.#.#.###.#.#.###.#####.#.#.#.#.#######.#.#######.#.###.#.###.###########.#.###.#.###########.#######.###.#.#.###.#.#.#>###.#.#.#
#...#.#.#...#...#.#...#.#...#.#.....#.#...#.....#.#...#.......#...#.#.#.#.......#.....#...#...#.........#...#.....#.#...#...#.#.#>>>#.....#.#
#####.#.###.#####.#.###.#####.#.###.#.#.#.#####.#.#.#####.###.###.###.#.#.#####.#.#####.#.#.###.#######.#####.#####.#.###.###.#.#>###.#####.#
#.....#.....#.....#...#.#.....#...#.#.#.....#.......#...#...#.#...#...#...#.......#.....#.#.#...#.............#.....#.#.#.#...#.#>#...#...#.#
#.#########.#.#######.#.#.#########.###.#####.#######.#.###.###.###.###.###.###.#.#.#####.#.#.#.#.#######.###.###.###.#.#.#.###.#>#.###.###.#
#.#.......#.#.......#.#...#.......#...#.#.........#...#...#...........#...#.......#.#...#.......#.........#.......#...#...#.....#>......#...#
#.#.#.###.#.#######.#######.#####.###.#.#.#.#####.#.#####.#.#########.###.#########.#.#.#.###########.#.###.###.#.#.###.#########>#######.#.#
#...#.#...#.#.....#.#.......#.........#.#.#.....#...#.....#...#.....#...#.#...#.....#.#.#...#.......#...#...#...#.....#.....#....>..#.....#.#
#####.#.###.#####.#.#.###.###.#######.#.#.#####.#.###.#######.#.###.#.#.#.#.###.#.###.#.###.#######.#####.###.###.###.#####.#####>#.#.#####.#
#.....#...#.....#.#...#...#...#.......#.#.#.....#.#...#...#...#.#...#.#.....#...#.....#...#.......#.....#...#.#.....#...#.#......>..#.....#.#
#.#.#######.###.#.#####.###.#.#.#######.#.###.#####.###.#.#####.#.###.#.#####.###.#######.#######.#.#.###.#.#.#########.#.#####.#>#######.#.#
#.#.#...........#...#...#...#...#.....#.#...#.......#...#.......#...#.....#...#.#...#...........#.#.#...........#.....#.#.#.....#>........#.#
#.#.#.#####.#######.#.#####.#####.###.#.###.#####.###.###########.#.#######.###.#.#.###.#####.###.#.###.#.#.###.#.###.#.#.#.###.#>#########.#
#.#.#...............#.....#.#.....#...#...#...#...#...#...#.....#.#...........#.#.#.....#.....#...#.#.#.....#...#...#.....#.#....>#.....#...#
#.#.#.#.#.#.#######.#####.#.#.#####.#####.###.#####.#####.#.###.#.#######.###.#.#.#####.#.#####.###.#.#######.#.###.#.#.#.#.#.#.#>###.###.###
#.#.#.#.#.#.......#.....#.#.#.....#.......#.#.....#...#...#...#.#.......#.#...#...#.....#.....#.#...#.......#.#...#.#.#.#...#.#..>>>#.......#
#.###.#.###.#####.#######.###.#.###########.#.#.#.###.#.#####.#.###.#####.#.###.###.###.#######.#.#.#####.#.#.#####.#.#.#####.#.###>#######.#
#.....#...#.....#...#...#...#.#.#.....#.....#...#...#.#.#.....#...#.#.....#.#.....#.#...#.....#.#...#...#.#.#.......#.........#...#>>>>>>>#.#
#.#######.#.###.###.#.#.###.#.#.#.#.###.#.#.#####.###.#.#.#######.#.#.###.#.#####.#.###.#.###.#.#.###.#.#.#.#######.#########.#.#.#######>###
#.....#...#.....#.#...#...#.#.#.#.#.....#.#...#...#...#.#.....#.#.#.#...#.#...#...#...#.#.#...#.#.#...#.#.#...#...#.#.....#.............#>>>#
#####.#.#.#.#####.#######.#.#.#.#.#######.###.#.###.###.#####.#.#.###.#.#####.#######.###.#.###.#.#.###.#.###.#.#.###.###.#.###.###.#######>#
#.#...#.#.#.#...#...........#.#...#...#.#...#.#...#...#...#.#...#...#.#.#...#.#.....#.#...#.....#...#.....#...#.#.....#.#.#.......#.#.....#>#
#.#.###.#.#.###.#.###########.#.###.#.#.###.#.###.###.#.#.#.#.#.###.###.#.#.#.#.###.#.#.#############.#########.#######.#.###.#.###.#.###.#>#
#...#...#.#.#...#.#...........#.....#.#.#...#...#...#...#.#.#.#...#.#...#.#.....#.....#.#...#.........#.........#.......#...#.#.....#.#...#>#
#.###.#.###.#.###.#.#######.#.#######.#.#.#####.###.#####.#.#.#.###.#.#.#.#######.###.#.#.#.#####.#####.#########.#####.###.#.#.#####.#.###>#
#...#.#...#.#.....#.#.....#...#...#...#.#.#.#.....#...#...#.#.#...#.#.#.#...#.......#.#...#.....#...#...#.....#...#...#...#.....#.....#.#..>#
###.#.###.#.#######.#.#########.#.###.#.#.#.#.###.#.###.###.#.#.#.#.#.#.###.#.#####.#####.#####.#.#.#.#####.#.#.#.#.#.###.###.#.#.#####.###>#
#...#.#...#.........#...........#...#...#.#.......#.....#...#.#.#.....#.#...#.....#.#...#.#.........#.#.....#.#.#...#.....#...#.#.#...#....>#
#.#.#.#.#########.#######.#########.###.#.#.#####.#######.###.###########.#######.#.#.#.###.#####.#.#.#.#####.#.#.#.#######.#.#.#.#.#.#####>#
#.#...#.#...............#.....#...#.#.#.#.#...#.#...#.......#...#.........#.#...#.#...#.....#...#...#.#.#...#.#.#.#...#.#...#.#.#...#.#.#>>>#
#.#.###.#.#######.#####.#.###.#.#.#.#.#.#.#.#.#.###.###.###.###.#.#########.#.#.#.#####.#####.#.#####.#.#.#.#.###.###.#.#.#####.###.#.#.#>###
#.#...#...#.......#...#.#.#...#.#.#.#...#.#.#.....#...#.#...#...#...#.#.......#.#...#...#.....#.........#.#.#.....#.......#...#.#......>>>#.#
#.#.#######.#########.#.#.#.#####.#.###.#.#.#####.###.#.#.#.#.#.###.#.#.#######.###.#####.#########.#####.#.#######.#####.#.#.#.#.#.###>###.#
#.#.#.....#.....#.....#.#.#.....#.#...#.#.#.....#.#...#...#.#.#.#...#.....#.....#...#...#.#...#.....#.....#...#.....#...#...#...#.....#>#...#
#.#.#.#.#.#####.#.#####.#.#####.#.#.#.#.#.#.###.###.#######.#.#.#.###.###.#.###.#.#.#.#.#.#.#.#.###.#######.#.#.#####.#.###########.#.#>#.#.#
#.#.#.#.................#.....#.#.#...#.#.#...#.....#.......#.#.#.#.....#.#.#...#.#.#.#...#.#.#.............#.#.#...#.#.........#.....#>#.#.#
#.#.#.#.#########.###.###.#####.#.#.#####.#.#####.###.#.#.###.###.#.#.#.###.#.###.###.#####.#.#.#.#############.###.#.#######.#.#.#.###>#.#.#
#.#.#.....#.....#.#.......#.....#.#.#.....#.#...#.....#...#...#...#.#.#.#...#...#.....#.....#.#...#...........#.#...#.#.....#........>>>..#.#
#.#.###.#.###.###.###.#.###.#####.#.#.#######.#.#######.###.#.#.#####.#.#.#####.###########.#.#.###.#########.#.#.###.#.#.#.#.###.#.#>###.#.#
#.#.....#.......#...#...#.#.#.....#.#.#...#...#.......#...#.#.........#.#...#.#...#.........#.#.........#...#.#.#...#.#.#.#.#...#.#.#>..#.#.#
#.#.###.###.###.#.#.###.#.#.###.#.#.#.#.#.#.#######.#.###.#.###.###.###.###.#.#.#.###.#######.#######.###.#.#.#.###.#.#.#.#.###.#.#.#>###.#.#
#.#...#.....#...#.#...#...#.#...#.#.#...#.#.......#.....#.#.#...#...#.#.........#...#.#.......#.....#.#...#.#.....#.#...#.#...#...#.#>....#.#
#.#.#.#.#####.#.#.###.#####.#.#####.#.###.#######.#.#.###.#.#.###.###.#########.###.#.#.#######.###.#.#.###.#####.#.#####.#.#######.#>#####.#
#.#.#.#.#.....#.....#.......#.#.....#...#...#...#.#.#.....#.#.#...#.....#.........#...#...#.....#.#.#...#.#...#.......#...#..........>......#
#.#.#.#.#####.###############.#.#######.#.#.###.#.#.###.###.#.#.#######.#.#.###########.###.#####.#.###.#.###.#########.#############>#######
#...#.#.....#...#.......#...#...#.......#.#...#.#.#...#.#.....#.#.......#.#.#.......#...#...#.....#...#.#...#.................#.....#>......#
###.#.#.###.#.#.#.#.###.###.#.#######.###.###.#.#.###.###.###.#.###.#.###.#.#.#.#.#.#.###.###.#######.#.#.#.#########.###.###.#.###.#>#####.#
#...#.#.#.#.#.#...#...#.....#.#.....#.#...#.#.#.#.#.#...#.#...#...#.......#...#...#.#.#.#.#.........#.#.#.#.#.......#.....#.#...#.#.#>..#.#.#
#.#.#.#.#.#.#########.#####.#.#.###.###.###.#.#.#.#.###.#.#.#####.#.###########.###.#.#.#.###.#.#.#.#.#.###.#.#.###.###.#.#.#####.#.#>#.#.#.#
#.#.#.#...#.#.......#...#...#...#.#...#.#.......#...#.#.#...#.....#.#...#.....#.....#.#.#...#.#...#...#...#.#.#.#.#.#.#.#.#.......#..>......#
#.###.###.#.#.#####.#.#.#.#######.#.#.#.###########.#.#.#####.#####.###.#.#.#####.###.#.###.###.#######.#.#.#.#.#.#.#.#.#.###.###.###>#.###.#
#.............#.#...#.#.#.#...#.....#.#...........#.#.#...........#...#...#.#...#.......#.#...#.........#.#...#.#.....#.#.#........>>>......#
#.#####.#.###.#.#.###.#.#.#.#.#.###.#.###.#####.###.#.#########.#.###.#####.#.#.#######.#.###.###.#####.#.#.###.#######.#.#.###.###>#####.#.#
#.#.....#.....#...#...#.#.#.#.#...#.#...#.#...#.#...#.....#.......#.#...#...#.#...#...#.....#.#.......#.#.#...#.....#...#.#.#...#..>....#.#.#
#.#.#####.#.###.#######.#.#.#####.#.###.#.#.#.#.#.###.#####.#######.###.#.###.###.#.#.#######.#######.###.###.#####.#.###.#.#.#####>###.#.#.#
#.............#.#...#.....#.....#.#.....#.#.#.#.#.#...#.....#.............#...#.#...#...#...#.......#...#.#...#...#.#.#.#...#.....#>..#.#.#.#
###.#.###.###.#.#.#.#.###.#.#.#.#.#######.#.#.#.#.#.#.#.#####.#############.###.#######.#.#.#######.###.#.#.###.###.#.#.#########.#>###.#.###
#...#...#...#.....#.#...#.#.#.#...#.....#...#.#.....#.#...#.#.#...#.....#...#.......#.#...#.#.......#.....#...#...#...#.....#...#.#>....#...#
#.###.#.#.###.#####.###.#.###.#.#.#.###.#####.###########.#.#.#.###.#####.#.#.###.#.#.#####.#.#######.#######.###.#######.###.#.#.#>#######.#
#...#.#...#...#...#.#...#...#.#.#.#.#.#...#.#.#.....#.....#.#.#.#...#.....#.....#.#...#...#.#.#.....#.........#...........#...#...#>....#...#
###.#.###.#.#####.#.#.#####.#.###.#.#.###.#.#.#.###.#.#####.#.#.#.###.###.#######.###.#.#.#.#.#.###.#.###.#.#.#.#######.###.#######>###.#.###
#...#...#.#.#...#.#.#.#.#...#...#...#.....#...#.#.#...#.#...#...#.#.#.#.#...#.....#.#.#.#.#.#.#.#...#.#...#.#.#.#.......#...#.#....>....#...#
#.#####.#.#.#.#.#.#.#.#.#.#####.#####.#####.###.#.#####.#.#.#.###.#.#.#.###.#.#####.#.#.#.#.#.#.###.#.#.###.#.#.#########.###.#.#.#>###.###.#
#.#.......#.#.#...#.#.#.#.#.....#...#.....#...#.#.........#...#...#.......#.#...#.......#.#...#.......#...#.#.#...........#...#.#.#>..#.#...#
#.#.#####.#.#.#####.#.#.#.###.#.#.#######.###.#.#.#####.#######.#.#######.#.###.###############.#########.#.#.###.###########.#.#.#>#.#.#.#.#
#.#.#.......#...#...#.#.#.#...#...#...#...#...#.#.......#...#.#.#...#.....#.#...#...............#.#...#...#.#...#.#.........#...#.#>#...#...#
#.#.#.#######.#.#.###.#.#.#.###.###.#.#.#######.#.#######.#.#.#.#.#.###.###.#.###.#########.#####.#.#.#.#######.#.#.#.#####.#.###.#>#######.#
#.#.#...#.....#.......#...#...#.#...#...#.......#.........#...#...#...#.#...#...............#.....#.#...#...#.......#.#...#.#.#...#>..#...#.#
#.#.###.#################.###.#.#.#######.#.#######.#################.#.#.###.#######.#####.#.###.#.#####.#.#.#########.#.#.###.###>###.#.#.#
#.#.#.#.....#.....#.....#.....#.#.....#.#.#.#.#.....#...#.........#...#.#.#...#...#.#.....#.#...#.#.......#.#.....#.....#.#.#...#>>>#...#...#
#.#.#.#####.#.###.#.###.#####.#######.#.#.#.#.#.#####.#.#.#######.#.###.#.#####.#.#.#.###.#.#.#.###########.#####.#.#####.#.#.###>###.#####.#
#.....#...#.......#...#.......#.......#...#.#.....#...#...#.......#.#...#.#.....#.#.#...#.#.#.#.......#>>>#>>>#.#...#...#.#...#..>>>#...#...#
#.#####.#.#######.#.###.#######.###########.#.#####.#######.#####.#.#####.#.#####.#.#.###.#.#.#######.#>#>#>#>#.#####.#.#.#########>###.#.#.#
#...#...#...#.....#.#...#.....#.....#.......#.#.#...#...#...#.....#.......#...#.#.#...#...#.#...#.....#>#>>>#>>>#.....#.#>>>>>#....>..#.....#
#####.#.###.#.#.###.#.#.#.###.#####.#.#######.#.#.#####.#.###.#############.#.#.#.#.###.#.#.###.#.#.#.#>#######>#.#####.#>###>#.###>#.#.#.#.#
#...#.#.....#.#.#...#.#.#.#.#.#.....#...........#.#.....#.#.#.#.............#.#.#.#...#.#.#.#...#.#.#.#>......#>#.#>>>>>>>..#>#.#..>....#...#
#.#.#.#.#####.###.###.#.#.#.#.#.#####.###.###.#.#.#.###.#.#.#.###.#######.###.#.#.#####.#.#.###.#.#.#.#>#.#.#.#>###>#######.#>#.###>#######.#
#.#...#.......#...#...#.#...#.#.....#.#.#.....#...#...#...#.#...#.#...#.......#...#.....#.#...#.#.#....>#...#.#>>>>>#.....#.#>#....>....#...#
#.#####.#.###.#.###.#.#####.#.#####.#.#.#####.###.###.###.#.###.#.#.#.#.#######.###.#########.###.#####>#####.###########.#.#>#####>###.#.#.#
#.#...#.....#.#...#.#.#...#.#.....#.#.#.....#.#...#...#...#.#...#.#.#.#.......#.#...#.......#.#...#.#..>#...#.#.........#...#>>>>>>>..#.#...#
#.#.#.#.#.###.###.#.#.#.#.#.#.###.#.#.#.###.#.#.###.###.###.#.#####.#.#.#.#.#.#.#.#.#.###.#.#.#.###.#.#>###.#.#.#######.#.#########.#.#.#.#.#
#.#.#...#.#.....#.#.....#...#...#.#.#...#...#...#...#...#...#.......#...#.#...#.#.#.#.#...#.#.#...#...#>>>..#.....#.....#...#.......#...#.#.#
#.#.###.#.#.#####.#############.#.#.#######.#####.#.#.###.#############.#.#.###.#.#.#.#.#.###.###.#.###.#>#.#######.#######.###.#.#.#######.#
#.#.#...#...#.....#.....#.....#.#.#...#...#.......#.#...#...#.........#...#.....#.#.#...#...#.....#.#...#>#.#.......#.....#...#.#.........#.#
#.#.#.###.###.#####.###.###.#.#.#####.#.#.#########.###.###.#.#####.#.#####.#####.#.#.#.###.#######.#####>#.#.#.#####.#######.###.#.###.#.#.#
#.#.#.#.#.#.#.#.......#.....#.#.....#...#.#.......#...#...#.#...#...#...#...#.....#.#...#.#...#...#.#...#>#.#.#.#...........#...#.#.....#...#
#.#.#.#.#.#.#.#.#####.###.#########.#####.#.###.###.#####.#.#.#.#.#######.###.#####.###.#.###.#.#.#.#.#.#>#.#.#.#.#######.#####.#.#.#######.#
#.#.........#.#.....#.#...#.......#.#.....#...#.....#.....#.....#.....#...#...#...#...#...#.#...#.#...#.#>#...#.#.....#...#.....#.#...#.#...#
#.#.#.###.#.#.###.###.#.###.###.###.#.#####.#########.#.#####.#######.#.###.###.#.#.#####.#.#####.#####.#>###.#.#####.#.###.#####.###.#.#.###
#...#.................#.#...#...#...#.....#.#.......#.#.#...#.....#...#.#.....#.#.#.....#.#.......#...#>>>#...#.#.....#.#...#...#.#.#.#.....#
#.#####.#####.#.###.#####.###.###.#.#####.###.#####.#.###.#.#####.#.#.#.#####.#.#######.#.###.#.#.#.#.#>#######.#######.#.###.#.#.#.#.#######
#...#.#.#...#.#...#.........#.....#.....#...#...#...#.....#...#.....#.#...#...#.......#.#.#...#.#...#..>#.......#.......#.#...#.#...#.#.....#
###.#.#.#.#.#.###.###########.#.#####.#####.###.#.###########.#.#.#######.#.###.#.###.#.#.#.#.#########>#.#######.#####.#.###.#.#####.#.###.#
#...#.#...#.#...#.#.........#.#.#...#.#.....#...#.......#...#.#...#...#.........#...#.#...#.#.#...#>>>#>#.#...#.....#...#.....#...#...#...#.#
#.###.#####.###.###.###.#.#.#.#.#.#.#.#.#####.#########.#.#.#.#.###.#.#.#######.###.#######.###.#.#>#>#>#.#.#.#.###.#############.#.###.###.#
#.#...#.....#...#...#...#.#...#.#.#...#.......#.....#...#.#...#...#.#...#.....#...#.#.....#.....#.#>#>>>#.#.#.#.#...#.....#.....#.#.....#...#
#.###.#.###.#.###.#####.#.###.#.###############.###.#.###.#####.#.#.#######.#####.#.#.#.#.#######.#>###.#.#.###.#.###.###.#.###.#.#####.#.###
#.....#.#...#...#.#...#.#...#.#.#...........#.....#.#.#...#.....#...#.......#...#.....#.#.....#...#>>>#.#.#.#...#.....#.#.#.#.#.#.....#.#...#
#.#.#.#.###.###.#.#.#.#.###.###.#.###.###.#.#######.#.###.#.###.#####.###.###.#.#.#####.#####.#.#.###>#.#.#.#.#########.#.#.#.#.#####.###.#.#
#...#.#...#.....#.#.#.#.....#...#.......#.#.........#...#.#...#...#.....#.....#.....#...#.#.....#.#>>>#...#.#.....#.....#...#.#.....#...#.#.#
#####.###.#.#.###.#.#.#######.#########.#.#######.#####.#.###.#.#.#######.#######.#.#.###.#.#.#.#.#>#######.#####.#.###.#####.#.###.###.###.#
#.#.....#.#.#...#.#.#.........#.......#.#.#.....#.#...#.#...#...#.#.....#.#.......#...#.#.......#.#>#...#.......#...#...#.....#...#...#...#.#
#.#.#.###.#.###.#.#.###.#####.#.#.#####.#.#.###.###.#.#.#.#.#####.#.###.###.#####.###.#.#.#########>#.#.#.###.#######.#.#.###.###.#######.#.#
#...#.....#...#...#.....#...#.#.#.......#.#...#.#...#.....#.#.....#...#.....#...#.#.......#...#>>>>>#.#.#...#.......#...#.#.#...#...#...#.#.#
#.###.###########.###.#.#.#.#.#.#########.###.#.#.#.#######.#.#######.#######.#.#.#########.#.#>#####.#.###.#.###.#.###.#.#.###.###.#.#.#.#.#
#.#.#.....#.......#.#.#.#.#.#.#.......#.....#.#...#...#.....#.#.....#.....#...#.#...........#.#>>>#...#...#.#...#.#.#...#.#.#...#.#...#.#...#
#.#.#####.#.#####.#.#.###.#.#######.#.#.#####.#####.#.###.###.#.###.###.#.#.###.#############.###>#######.#.#.#.#.#.#.###.#.#.###.#####.###.#
#...#...#.#...#.....#.....#.......#.........#.#.....#.#...#.#.#...#...#.#.....#.......#.....#...#>>>>>>>>>..#.#...#.#.#...#.#.#.......#.....#
###.#.#.#.###.#.###.#############.#.#######.#.#####.#.#.###.#.###.###.#.#########.###.#.#.#####.#.#####.#>###.#####.#.#.###.#.#.###.#########
#...#.#.#.#...#.#...#...........#.#.....#.......#>>>#...#...#...#.#.#.#...#.#.........#.#.......#...#...#>#.#.....#...#...#...#.#...#.....#.#
#####.#.#.#.###.#.###.###.#####.#.#####.#.#####.#>#>#####.#####.#.#.#.###.#.#.###########.###########.###>#.#####.#.#####.###.###.###.#.#.#.#
#...#.....#.#...#.....#...#...#.#.....#.#.#.....#>#>....#.....#...#...#.#.#.#...........#........>>>>>>>>>#...#...#.....#...#...#.....#.#.#.#
#.#.#.###.#.#.#.#######.###.#.#######.#.#.#.#####>#>#.#.#.###.#####.###.#.#.#########.#.#######.#>#####.#.###.#.#.#####.#.#.###.#######.#.#.#
#.#...#.....#.#.....#...#...#.........#.#...#>>>>>#>..#...#...........................#...#...#.#>#...#.....#.#.....#...#.#...#.....#...#.#.#
#.###.#.#.###.#.###.#.###.#.#########.#.#.###>#####>#####.#.#.#.###.#.#.###.#.#######.###.#.###.#>#.#.###.#.#.#.###.#.#.#.###.#####.#.###.#.#
#...#.#.....#.#>>>#.#.#...#.#...#...#.#...#..>>>>>#>..#.#...#.#.#...#.#...#.#.....#...#...#.....#>..#...#.....#.#...#.#.....#.....#.#.#.....#
#.#.#.###.#.#.#>#>#.###.###.#.#.#.#.#.###.#######>#>#.#.#.#.#.#.#.#######.#.#####.#.#.#.###.#####>#####.#.#####.#.#.#.#.#######.#.#.#.#.###.#
#.#.#.....#.#..>#>#.....#.#.#.#...#.#...#...#>>>>>#>..#...#...#.#.......#.......#.#.#...#...#....>>>>>#.....#...#.#...#.#.....#.#.#.#.....#.#
#.#.#####.#.#.#>#>#######.#.#.#####.#####.#.#>#####>###.#.#.###.#######.#.#.#####.#.#.###.###########>#####.#.#.###.#.#.#.###.###.#.###.#.#.#
#.#.#...#.#.#.#>#>>>#.......#.....#.......#.#>#....>#...#.#.......#...#...#.#>>>>>>>>>>>>>>>>>>>>>>>>>..#...#.#.....#...#...#.#...#.......#.#
###.#.#.#.#.#.#>###>###########.#.#####.#.#.#>#.#.#>###.#.#.#####.#.#.###.###>#####.###.#.#.###.#.#.###.#.###.#.###.#.#####.#.#.#######.###.#
#...#.#.....#.#>..#>#>>>>>>>>>..#.#...#.....#>#.#.#>..#....................>>>..#.#.#...#...#...#.#.....#.#.....#...........#.#...#.#...#...#
#.#.#.###.#####>#.#>#>#######>###.#.#########>#.###>#.###.#.#####.#.#.###.#>#.#.#.#.#.#######.#########.#.###.###.#.#.#######.###.#.#.#.#.###
#.#.#.#>>>#>>>>>#.#>#>#.....#>#...#........>>>#...#>>>>>>>>>>>>>>>>>>>>>>>>>#.#.#...#.#.#...#.#.............#...#.......#...#.....#...#.....#
#.###.#>#>#>#####.#>#>#####.#>#.###########>###.#.#.###.#.#.###.###.#.#.#.#.###.#.###.#.#.#.#.#.#.#.#.#####.###.###.#.#.#.#.#######.###.#.#.#
#S>>>>>>#>>>#.....#>>>......#>>>>>>>>>>>>>>>#...#.....#.......#.....#...#.......#.....#...#.....#...#.......#...........#.#.................#
#############################################################################################################################################